{
    "width" : 10,
	"depth" : 10,

	"sunlight" : [ -1, 1, 0 ],

	"altitude" : [
	    0, 0, 0, 0, 0, 0, 0, 0, 0, 0,
	    0, 1, 1, 1, 1, 1, 1, 1, 1, 0,
	    0, 1, 1, 1, 1, 1, 1, 1, 1, 0,
	    0, 1, 1, 2, 2, 2, 2, 1, 1, 0,
	    0, 1, 1, 2, 3, 3, 2, 1, 1, 0,
	    0, 1, 1, 2, 3, 3, 2, 1, 1, 0,
	    0, 1, 1, 2, 2, 2, 2, 1, 1, 0,
	    0, 1, 1, 1, 1, 1, 1, 1, 1, 0,
	    0, 1, 1, 1, 1, 1, 1, 1, 1, 0,
	    0, 0, 0, 0, 0, 0, 0, 0, 0, 0,
	],

	"trees" : [
		{
			"x" : 1.5,
			"z" : 1.5
		},
		{
			"x" : 4.5,
			"z" : 4.5
		}
	],

	"roads" : [
		{
			"width" : 3,
			"spine": [
				1.5, 3,
				1.5, 0.5,
				7.5, 1.5,
				7.5, 1.5
			]
		}
	]
}